00010001
00000001
00010001
10110111
00010000
00000000
00010000
11111111